1111111111111111111111111111111111
1E0000000000C00000000000C000000001
1010010100100000101001000000010101
1010010010101010C0100100C000010101
1P0000000000C000000000000C00000001
1111111111111111111111111111111111