1111111111111
1P00C000001C1
1011101110101
1000000010001
1110111010111
10001C0010C01
101C111110111
100000C0000E1
1111111111111