11111111111111111
1P00C0000C0000001
10111111101111101
100010000C0001001
10101111101010101
1C0010000000C0011
10111111111011101
100010000C0001001
10101110111110101
1C0001C00E0010001
11111111111111111