11111111111111111
1P0C000C00C0C0001
101X1011101110101
10C010C010C001001
1110101010X01C101
1C00101X10C000C11
1010101011101C101
100010C010X001001
11101010111010101
1C0001000E0000C01
11111111111111111