11111111111111111
1P0C0X0C00C0C0001
10101011101110101
10C010C010C001001
1110101010101C101
1C00101010C0X0C11
1010101011101C101
100010C0100001001
11101010111010101
1C00010X0E0000C01
11111111111111111